########
## #   E
^  # ###
#      #
########