################
## #     ##   ##
^  # ###  # #  #
#    ###    ## #
##############E#